IA	grey
ACM	red
ALICE	red
CEAT	red
LABA	red
LAC	red
LAMU	red
LAST	red
SUB	red
LAURE	red
EAST	red
LIV	red
LAB-U	red
LEURE	red
LCC	red
CNPA	red
LDM2	red
MANSLAB	red
LASUR	red
LTH2	red
LTH3	red
LAPIS	red
TSAM	red
LIPID	red
FORM	red
IIC	grey
LHE	blue
IMAC	blue
LESO-PB	blue
IBOIS	blue
IBETON	blue
CCLAB	blue
LCH	blue
ICOM	blue
MCS	blue
LMR	blue
LMS	blue
LSMS	blue
LUTS	blue
LAVOC	blue
EESD	blue
TRANSP-OR	blue
UPLECAMPION	blue
UPVIOLAY	blue
IIE	grey
WIRE	green
ECHO	green
LBE	green
LCE	green
LGB	green
EML	green
LMCE	green
EFLUM	green
APHYS	green
SBER	green
APRL	green
LASIG	green
DISAL	green
ECOL	green
TOPO	green
TOX	green
LTE	green
CRYOS	green
ECOS	green
LTQE	green
UPHCE	green
UPSSC	green